2 tone	caribbean and caribbean-influenced
2-step garage	electronic
4-beat	electronic
a cappella	rock
abstract hip hop	hip hop
abstract idm	electronic
acid breaks	electronic
acid house	electronic
acid jazz	jazz
acid rock	rock
acid techno	electronic
acid trance	electronic
acousmatic	electronic
acousmatic music	electronic
acoustic blues	blues
acoustic pop	pop
adult contemporary	pop
adult standards	pop
african	african
african blues	blues
african gospel	blues
african heavy metal	african
african hip hop	african
african percussion	african
african rock	rock
afro / cosmic disco	electronic
afro-cuban jazz	latin
afrobeat	african
afrobeats	african
aggrotech	electronic
albanian pop	pop
album rock	rock
albuquerque indie	electronic
alt-indie rock	rock
alternative americana	country
alternative country	country
alternative dance	electronic
alternative emo	rock
alternative hardcore	electronic
alternative hip hop	hip hop
alternative metal	rock
alternative metalcore	rock
alternative pop	pop
alternative pop rock	rock
alternative r&b	r&b and soul
alternative rock	rock
alternative roots rock	rock
ambient	electronic
ambient dub	electronic
ambient dub techno	electronic
ambient fusion	caribbean and caribbean-influenced
ambient house	electronic
ambient idm	electronic
ambient psychill	electronic
american folk revival	folk
americana	country
anarcho punk	rock
anarcho-punk	rock
anison	asian
anthem emo	rock
anti-folk	folk
antiviral pop	pop
apala	african
appalachian folk	folk
arab folk	folk
arab pop	pop
argentine indie	electronic
argentine reggae	caribbean and caribbean-influenced
argentine rock	rock
armenian folk	folk
art punk	rock
art rock	rock
asian	asian
asian american jazz	jazz
asian underground	electronic
athens indie	electronic
atlanta hip hop	hip hop
atmospheric black metal	rock
atmospheric post rock	rock
atmospheric post-metal	rock
australian alternative rock	rock
australian country music	country
australian dance	caribbean and caribbean-influenced
australian hip hop	hip hop
australian indie	electronic
australian pop	pop
austrian hip hop	hip hop
austropop	pop
avant-garde	avant-garde
avant-garde jazz	jazz
avant-garde metal	rock
avantgarde metal	rock
axé	latin
bachata	latin
background music	easy listening
baila	asian
baile funk	r&b and soul
baithak gana	caribbean and caribbean-influenced
bakersfield sound	country
balearic	electronic
balearic beat	electronic
balearic trance	electronic
baltimore club	hip hop
banda	latin
baroque	pop
baroque ensemble	pop
baroque pop	pop
basque rock	rock
bass music	caribbean and caribbean-influenced
bass trap	hip hop
bass trip	hip hop
bassline	electronic
bassline/4x4 garage	electronic
baul	asian
bay area indie	electronic
beat music	rock
beautiful music	easy listening
bebop	jazz
belgian indie	electronic
belgian rock	rock
belly dance	caribbean and caribbean-influenced
benga	african
berlin school	electronic
bhangra	asian
big band	jazz
big beat	electronic
big room	electronic
bikutsi	african
bitpop	electronic
black death	rock
black metal	rock
black sludge	rock
black thrash	rock
blue-eyed soul	r&b and soul
bluegrass	country
blues	blues
blues country	country
blues rock	blues
blues shouter	blues
blues-rock	rock
blues-rock guitar	rock
bolero	latin
bongo flava	hip hop
boogie	r&b and soul
boogie-woogie	jazz
bossa nova	latin
bossa nova jazz	jazz
boston rock	rock
bounce	electronic
bounce music	hip hop
bouncy house	electronic
bouncy techno	electronic
bouyon	caribbean and caribbean-influenced
bow pop	pop
boy band	jazz
brass band	jazz
brazilian	latin
brazilian ccm	latin
brazilian composition	latin
brazilian gospel	blues
brazilian hip hop	hip hop
brazilian indie	electronic
brazilian punk	rock
brazilian rock	latin
breakbeat	electronic
breakbeat hardcore	electronic
breakcore	electronic
breaks	electronic
breakstep	electronic
brega	latin
breton folk	folk
brick city club	hip hop
brill building	pop
brill building pop	pop
british alternative rock	rock
british blues	blues
british brass band	jazz
british dance band	jazz
british folk	folk
british folk revival	folk
british hip hop	hip hop
british indie rock	rock
british invasion	jazz
britpop	pop
broken beat	electronic
brooklyn indie	electronic
brostep	electronic
brutal death metal	rock
brutal deathcore	rock
bubble trance	electronic
bubblegum dance	electronic
bubblegum pop	pop
bulgarian folk	folk
bullerengue	latin
c-pop	pop
cabaret	rock
cadence-lypso	caribbean and caribbean-influenced
cajun	country
cajun fiddle tunes	country
calypso	caribbean and caribbean-influenced
canadian blues	blues
canadian country	country
canadian hip hop	hip hop
canadian indie	electronic
canadian metal	rock
canadian pop	pop
canción	pop
candy pop	pop
cante flamenco	latin
canterbury scene	rock
cantopop	asian
canzone	pop
canzone napoletana	pop
cape jazz	jazz
caribbean and caribbean-influenced	caribbean and caribbean-influenced
catstep	electronic
celtic	folk
celtic christmas	folk
celtic metal	rock
celtic music	folk
celtic punk	rock
celtic rock	rock
central asian folk	folk
cha cha cha	caribbean and caribbean-influenced
chalga	pop
chamber choir	jazz
chamber jazz	jazz
chamber pop	pop
chamber psych	pop
channel pop	pop
chanson	pop
chanson quebecois	pop
chaotic black metal	rock
chaotic hardcore	electronic
chap hop	hip hop
charred death	rock
chicago blues	blues
chicago hip hop	hip hop
chicago house	electronic
chicago indie	electronic
chicago soul	r&b and soul
chicano rap	hip hop
chicha	latin
children's music	caribbean and caribbean-influenced
chilean rock	rock
chill groove	rock
chill lounge	easy listening
chill-out	electronic
chillstep	electronic
chillwave	electronic
chimurenga	african
chinese indie rock	rock
chinese rock	rock
chinese traditional	latin
chip hop	hip hop
chiptune	electronic
chopped and screwed	hip hop
choro	latin
christian alternative rock	rock
christian christmas	country
christian country music	country
christian hardcore	electronic
christian hip hop	hip hop
christian metal	rock
christian music	caribbean and caribbean-influenced
christian pop	pop
christian punk	rock
christian relaxative	country
christian rock	rock
christian uplift	electronic
chutney	caribbean and caribbean-influenced
chutney soca	caribbean and caribbean-influenced
cinematic dubstep	electronic
classic	orchestral
classic afrobeat	african
classic colombian pop	pop
classic country	country
classic czech pop	pop
classic eurovision	orchestral
classic female blues	blues
classic finnish rock	rock
classic french pop	pop
classic funk rock	rock
classic garage rock	rock
classic icelandic pop	pop
classic italian pop	pop
classic norwegian pop	pop
classic peruvian pop	pop
classic polish pop	pop
classic rock	rock
classic russian rock	rock
classic schlager	pop
classic soundtrack	orchestral
classic swedish pop	pop
classic turkish pop	pop
classical	orchestral
classical christmas	orchestral
classical crossover	pop
classical flute	orchestral
classical guitar	orchestral
classical organ	orchestral
classical performance	orchestral
classical period	orchestral
classical piano	orchestral
close harmony	country
coldwave	electronic
college a cappella	rock
colombian rock	rock
columbus ohio indie	electronic
comedy	comedy
comedy music	comedy
comedy rock	comedy
compas	caribbean and caribbean-influenced
complextro	electronic
composition d	rock
compositional ambient	electronic
congolese rumba	african
conscious hip hop	hip hop
contemporary classical	orchestral
contemporary country	country
contemporary folk	folk
contemporary jazz	jazz
contemporary post-bop	jazz
contemporary r&b	r&b and soul
continental jazz	jazz
cool jazz	jazz
corsican folk	folk
country	country
country blues	blues
country christmas	country
country dawn	country
country gospel	blues
country pop	pop
country rap	country
country road	easy listening
country rock	country
country-rap	hip hop
coupé-décalé	african
cowboy western	country
cowboy/western music	folk
cowpunk	rock
criolla	latin
croatian pop	pop
crossover jazz	jazz
crossover prog	electronic
crossover thrash	rock
crunk	hip hop
crunkcore	hip hop
crust punk	rock
crustgrind	rock
cryptic black metal	rock
cuban rumba	latin
cumbia	latin
cumbia funk	r&b and soul
cumbia pop	pop
cumbia rap	hip hop
cumbia sonidera	latin
cumbia villera	latin
cyber metal	rock
cybergrind	electronic
czech folk	folk
czech rock	rock
d-beat	rock
dance pop	pop
dance rock	rock
dance-pop	pop
dance-punk	electronic
dance-rock	electronic
dancehall	caribbean and caribbean-influenced
dancehall music	caribbean and caribbean-influenced
dangdut	asian
danish hip hop	hip hop
danish indie	electronic
danish jazz	jazz
danish pop	pop
danish pop rock	rock
dansband	country
dansband music	country
dark ambient	electronic
dark black metal	rock
dark cabaret	rock
dark electro	electronic
dark electro-industrial	electronic
dark hardcore	electronic
dark jazz	jazz
dark minimal techno	electronic
dark progressive house	electronic
dark psytrance	electronic
dark wave	electronic
darkcore	electronic
darkcore jungle	electronic
darkstep	electronic
death 'n' roll	rock
death core	electronic
death industrial	electronic
death metal	rock
death-doom	rock
deathcore	rock
deathrock	rock
deep acoustic pop	pop
deep adult standards	pop
deep australian indie	electronic
deep big room	electronic
deep brazilian pop	pop
deep breakcore	electronic
deep canadian indie	electronic
deep ccm	electronic
deep cello	electronic
deep chill	electronic
deep chill-out	r&b and soul
deep chiptune	electronic
deep christian rock	rock
deep classical piano	orchestral
deep comedy	comedy
deep contemporary country	country
deep cumbia sonidera	latin
deep danish pop	pop
deep darkpsy	electronic
deep deep house	electronic
deep delta blues	blues
deep disco house	electronic
deep discofox	r&b and soul
deep downtempo fusion	caribbean and caribbean-influenced
deep dub techno	electronic
deep dutch hip hop	hip hop
deep euro house	electronic
deep eurodance	electronic
deep folk metal	rock
deep free jazz	jazz
deep freestyle	r&b and soul
deep full on	electronic
deep funk	r&b and soul
deep funk carioca	latin
deep funk house	electronic
deep german hip hop	hip hop
deep german indie	electronic
deep german jazz	jazz
deep german pop rock	rock
deep german punk	rock
deep gothic post-punk	rock
deep groove house	electronic
deep happy hardcore	electronic
deep hardcore	electronic
deep hardcore punk	rock
deep hardstyle	electronic
deep house	electronic
deep indian pop	pop
deep indie pop	pop
deep indie r&b	r&b and soul
deep indie singer-songwriter	latin
deep italo disco	r&b and soul
deep jazz fusion	caribbean and caribbean-influenced
deep jazz guitar	jazz
deep jazz piano	jazz
deep latin christian	country
deep latin hip hop	hip hop
deep latin jazz	jazz
deep liquid	electronic
deep liquid bass	electronic
deep melodic death metal	rock
deep melodic euro house	electronic
deep melodic hard rock	rock
deep melodic metalcore	rock
deep minimal techno	electronic
deep neo-synthpop	pop
deep new americana	country
deep new wave	electronic
deep norteno	electronic
deep opera	hip hop
deep orchestral	orchestral
deep pop edm	blues
deep pop punk	rock
deep pop r&b	r&b and soul
deep power-pop punk	rock
deep progressive trance	electronic
deep psychobilly	rock
deep psytrance	electronic
deep rai	jazz
deep regional mexican	pop
deep smooth jazz	jazz
deep soft rock	rock
deep soul house	electronic
deep soundtrack	electronic
deep southern trap	hip hop
deep space rock	rock
deep string quartet	electronic
deep sunset lounge	easy listening
deep surf music	caribbean and caribbean-influenced
deep swedish hip hop	hip hop
deep swedish indie pop	pop
deep swedish rock	rock
deep symphonic black metal	rock
deep taiwanese pop	pop
deep tech house	electronic
deep texas country	country
deep thrash metal	rock
deep trap	hip hop
deep tropical house	electronic
deep turkish pop	pop
deep underground hip hop	hip hop
deep uplifting trance	electronic
deep vocal jazz	jazz
delta blues	blues
demoscene	rock
depressive black metal	rock
desert blues	blues
desert rock	rock
destroy techno	electronic
detroit blues	blues
detroit hip hop	hip hop
detroit techno	electronic
digital hardcore	rock
dirty south rap	hip hop
dirty texas rap	hip hop
disco	r&b and soul
disco house	electronic
disco polo	pop
discofox	r&b and soul
diva house/handbag house	electronic
dixieland	jazz
djent	rock
dominican pop	pop
doo-wop	rock
doom metal	rock
doomcore	electronic
downtempo	electronic
downtempo fusion	caribbean and caribbean-influenced
dream pop	rock
dream trance	electronic
drill	hip hop
drill and bass	electronic
drone	electronic
drone folk	folk
drone metal	rock
drone music	electronic
drone psych	pop
drum and bass	electronic
drumfunk	r&b and soul
drumstep	electronic
dub	electronic
dub techno	electronic
dubstep	electronic
dubsteppe	electronic
dubstyle	electronic
dubtronica	electronic
dunedin sound	rock
dutch hip hop	hip hop
dutch house	electronic
dutch pop	pop
dutch rock	rock
dwn trap	hip hop
early music	caribbean and caribbean-influenced
early music ensemble	caribbean and caribbean-influenced
east coast hip hop	hip hop
easy listening	easy listening
ectofolk	folk
edm	blues
electric blues	blues
electro	hip hop
electro bailando	asian
electro dub	electronic
electro house	electronic
electro jazz	jazz
electro latino	latin
electro music	hip hop
electro swing	electronic
electro trash	hip hop
electro-industrial	electronic
electroacoustic	avant-garde
electroacoustic improvisation	jazz
electroacoustic music	electronic
electroclash	electronic
electronic	electronic
electronic body music	electronic
electronic rock	rock
electronic trap	hip hop
electronica	electronic
electronicore	rock
electropop	pop
electropowerpop	pop
electropunk	electronic
elevator music	easy listening
emo	rock
emo punk	rock
enka	asian
escape room	electronic
estonian pop	pop
ethereal wave	electronic
etherpop	pop
ethiopian pop	pop
ethnic electronica	electronic
ethno jazz	jazz
euro disco	electronic
eurobeat	pop
eurodance	electronic
european free jazz	jazz
europop	pop
euroska	caribbean and caribbean-influenced
experimental	rock
experimental dubstep	electronic
experimental hip hop	hip hop
experimental music	avant-garde
experimental psych	pop
experimental rock	rock
fado	pop
fann at-tanbura	asian
faroese pop	pop
fast melodic punk	rock
fidget house	electronic
fijiri	asian
filk music	folk
filmi	asian
filter house	electronic
filthstep	electronic
finnish hardcore	electronic
finnish hip hop	hip hop
finnish indie	electronic
finnish jazz	jazz
finnish metal	rock
finnish pop	pop
flamenco	latin
flick hop	hip hop
float house	electronic
florida breaks	electronic
folk	folk
folk christmas	folk
folk metal	rock
folk pop	pop
folk punk	rock
folk rock	rock
folk-pop	pop
folklore argentino	folk
folkmusik	folk
folktronica	folk
forró	latin
fourth world	rock
franco-country	country
freak folk	folk
freakbeat	rock
free funk	jazz
free improvisation	jazz
free jazz	jazz
free tekno	electronic
freestyle	r&b and soul
freestyle music	r&b and soul
freestyle rap	hip hop
french folk	folk
french folk pop	pop
french hip hop	hip hop
french house	electronic
french indie pop	pop
french indietronica	electronic
french movie tunes	country
french pop	pop
french punk	rock
french reggae	caribbean and caribbean-influenced
french rock	rock
frevo	latin
fuji music	african
full on	electronic
funeral doom	rock
funk	r&b and soul
funk carioca	latin
funk metal	rock
funk rock	rock
funkstep	electronic
funktronica	electronic
funky breaks	electronic
funky house	electronic
funky tech house	electronic
furniture music	easy listening
future ambient	electronic
future garage	electronic
future house	electronic
futurepop	electronic
g funk	r&b and soul
g-funk	hip hop
gabba	electronic
game boy music	electronic
gamelan	asian
gangsta rap	hip hop
gangster rap	hip hop
garage house	electronic
garage pop	pop
garage psych	pop
garage punk	rock
garage punk blues	blues
garage rock	rock
gauze pop	pop
geek rock	rock
genge	african
german hip hop	hip hop
german indie	electronic
german metal	rock
german oi	african
german pop	pop
german pop rock	rock
german punk	rock
german show tunes	country
german street punk	rock
german techno	electronic
ghetto house	hip hop
ghettotech	hip hop
glam metal	rock
glam rock	rock
glitch	electronic
glitch beats	electronic
glitch hop	electronic
go-go	r&b and soul
goa trance	electronic
golden age hip hop	hip hop
goregrind	rock
gospel	blues
gospel blues	blues
gothic americana	country
gothic metal	rock
gothic post-punk	rock
gothic rock	rock
gothic symphonic metal	rock
grave wave	electronic
greek hip hop	hip hop
greek house	electronic
greek indie	electronic
grim death metal	rock
grime	hip hop
grindcore	rock
grindie	electronic
grisly death metal	rock
groove metal	rock
groove room	electronic
grunge	rock
grunge pop	pop
grupera	latin
guajira	latin
gypsy jazz	jazz
gypsy punk	rock
hands up	latin
happy hardcore	electronic
hard alternative	country
hard bop	jazz
hard glam	rock
hard house	electronic
hard minimal techno	electronic
hard nrg	electronic
hard rock	rock
hard stoner rock	rock
hard trance	electronic
hardbag	electronic
hardcore	electronic
hardcore breaks	electronic
hardcore hip hop	hip hop
hardcore punk	rock
hardcore techno	electronic
hardstep	electronic
hardstyle	electronic
harmonica blues	blues
heavy christmas	rock
heavy metal	rock
hellbilly music	country
hi-nrg	electronic
highlife	african
hill country blues	blues
hindustani classical	orchestral
hip hop	hip hop
hip hop quebecois	hip hop
hip hop soul	r&b and soul
hip house	hip hop
hip pop	hip hop
hiplife	hip hop
hokum	country
hokum blues	blues
hong kong english pop	asian
honky tonk	country
horror punk	rock
horrorcore	hip hop
house	electronic
house music	electronic
houston hip hop	hip hop
huayno	latin
hungarian hip hop	hip hop
hungarian pop	pop
hungarian rock	rock
hyphy	hip hop
icelandic pop	pop
idm	electronic
igbo highlife	african
igbo rap	hip hop
illbient	electronic
indian classical	orchestral
indian pop	asian
indian rock	rock
indie anthem-folk	folk
indie christmas	electronic
indie dream pop	pop
indie emo	rock
indie emo rock	rock
indie folk	folk
indie fuzzpop	pop
indie garage rock	rock
indie jazz	jazz
indie pop	pop
indie poptimism	pop
indie psych-pop	pop
indie psych-rock	rock
indie punk	rock
indie r&b	r&b and soul
indie rock	rock
indie rockism	rock
indie shoegaze	rock
indie singer-songwriter	latin
indietronica	electronic
indonesian indie	electronic
indonesian pop	pop
indorock	rock
industrial	electronic
industrial folk	folk
industrial hip hop	hip hop
industrial metal	rock
industrial music	electronic
industrial rock	rock
instrumental country	country
instrumental hip hop	hip hop
instrumental post rock	rock
intelligent dance music	caribbean and caribbean-influenced
iranian pop	pop
irish country	country
irish folk	folk
irish indie	electronic
irish rock	rock
isicathamiya	african
isolationism	electronic
israeli rock	rock
italian arena pop	pop
italian disco	r&b and soul
italian folk	folk
italian hip hop	hip hop
italian indie pop	pop
italian jazz	jazz
italian metal	rock
italian pop	pop
italian pop rock	rock
italian progressive rock	rock
italian punk	rock
italo dance	pop
italo disco	pop
italo house	electronic
j-ambient	electronic
j-core	electronic
j-dance	caribbean and caribbean-influenced
j-indie	electronic
j-metal	rock
j-pop	pop
j-punk	rock
j-reggae	caribbean and caribbean-influenced
j-rock	asian
jam band	jazz
jangle pop	pop
japanese city pop	pop
japanese psychedelic	pop
japanese traditional	latin
japanoise	electronic
jazz	jazz
jazz bass	electronic
jazz blues	jazz
jazz brass	jazz
jazz christmas	jazz
jazz composition	jazz
jazz funk	r&b and soul
jazz fusion	jazz
jazz house	electronic
jazz metal	rock
jazz orchestra	orchestral
jazz rap	jazz
jazz rock	rock
jazz trio	jazz
jazz-funk	jazz
jerkin'	hip hop
jersey club	electronic
jig and reel	jazz
jit	african
jump blues	blues
jump up	latin
jump-up	electronic
jumpstyle	electronic
jungle	electronic
jùjú	african
k-hop	hip hop
k-indie	electronic
k-pop	pop
k-rock	rock
kadongo kamu	african
kansas city blues	jazz
kansas city jazz	jazz
kapuka aka boomba	african
kayōkyoku	asian
kc indie	electronic
keroncong	asian
khaliji	asian
kiwi rock	rock
kizomba	african
korean pop	pop
kraut rock	rock
krautrock	rock
kuduro	african
kurdish folk	folk
kwaito	hip hop
kwaito house	electronic
kwassa kwassa	african
kwela	african
la indie	electronic
lambada	latin
laptronica	electronic
latin	latin
latin alternative	latin
latin ballad	pop
latin christian	latin
latin christmas	latin
latin electronica	electronic
latin hip hop	hip hop
latin house	electronic
latin jazz	latin
latin metal	rock
latin pop	pop
latin rock	latin
latin swing	latin
latvian pop	pop
lavani	asian
laïkó	pop
leeds indie	electronic
lento violento	electronic
library music	caribbean and caribbean-influenced
lift kit	electronic
light music	caribbean and caribbean-influenced
liquid dubstep	electronic
liquid funk	electronic
livetronica	jazz
liwa	asian
lo star	blues
lo-fi	avant-garde
louisiana blues	blues
louisiana swamp pop	pop
louisville indie	electronic
lounge	easy listening
lounge house	electronic
lounge music	easy listening
lovers rock	caribbean and caribbean-influenced
low bap	hip hop
lowercase	electronic
luk krung	asian
luk thung	asian
lyrical hip hop	hip hop
m-base	jazz
mafioso rap	hip hop
mainstream jazz	jazz
makossa	african
malagasy folk	folk
malaysian pop	pop
maloya	african
mambo	latin
mande pop	pop
mandopop	pop
manila sound	asian
maracatu	latin
marching band	jazz
mariachi	latin
marrabenta	african
martial industrial	electronic
math pop	pop
math rock	rock
mathcore	rock
mbalax	african
mbaqanga	african
mbube	african
medieval	rock
medieval metal	rock
medieval rock	rock
melbourne bounce	electronic
mellow gold	hip hop
melodic death metal	rock
melodic hard rock	rock
melodic hardcore	electronic
melodic metalcore	rock
melodic power metal	rock
melodic progressive metal	rock
memphis blues	blues
memphis hip hop	hip hop
memphis soul	r&b and soul
merengue	latin
merengue urbano	latin
merenrap	hip hop
metal	rock
metal guitar	rock
metalcore	rock
metropopolis	pop
mexican indie	electronic
mexican pop	pop
mexican rock-and-roll	rock
mexican son	latin
mexican traditional	latin
miami bass	hip hop
michigan indie	electronic
microhouse	electronic
microhouse/minimal house	electronic
middle of the road	easy listening
midwest hip hop	hip hop
military band	jazz
minimal	electronic
minimal dub	electronic
minimal dubstep	electronic
minimal melodic techno	electronic
minimal tech house	electronic
minimal techno	electronic
minimal wave	electronic
mod revival	rock
modal jazz	jazz
modern blues	blues
modern classical	orchestral
modern country rock	rock
modern free jazz	jazz
modern southern rock	rock
moombahcore	electronic
moombahton	electronic
morlam	asian
morna	african
mosambique	caribbean and caribbean-influenced
motswako	hip hop
movie tunes	country
musique concrete	electronic
musique concrète	electronic
mákina	electronic
méringue	caribbean and caribbean-influenced
música criolla	latin
música popular brasileira	latin
música sertaneja	latin
nagoya kei	rock
nashville sound	country
native american	folk
ndombolo	african
nederpop	pop
neo classical metal	rock
neo honky tonk	country
neo mellow	r&b and soul
neo metal	rock
neo soul	r&b and soul
neo soul-jazz	jazz
neo-bop jazz	jazz
neo-industrial rock	rock
neo-progressive	electronic
neo-psychedelia	rock
neo-psychedelic	pop
neo-rockabilly	country
neo-singer-songwriter	latin
neo-swing	jazz
neo-synthpop	pop
neo-trad metal	rock
neoclassical	orchestral
neoclassical metal	rock
neofolk	folk
neotraditional country	country
nerdcore	hip hop
neue deutsche harte	rock
neue deutsche härte	rock
neue deutsche welle	rock
neurofunk	electronic
neurohop	electronic
neurostep	electronic
new age	rock
new age piano	rock
new americana	country
new beat	electronic
new jack swing	r&b and soul
new jersey hip hop	hip hop
new orleans blues	blues
new orleans jazz	jazz
new prog	rock
new rave	electronic
new romantic	pop
new romanticism	pop
new school hip hop	hip hop
new tribe	hip hop
new wave	rock
new wave pop	pop
new weird america	folk
new-age music	electronic
nintendocore	electronic
nitzhonot	electronic
nl folk	folk
no wave	rock
noise	avant-garde
noise pop	pop
noise punk	rock
noise rock	rock
noisegrind	rock
nordic folk	folk
nordic house	electronic
nortec	electronic
norteño	latin
northern irish indie	electronic
northern soul	r&b and soul
norwegian gospel	blues
norwegian hip hop	hip hop
norwegian indie	electronic
norwegian jazz	jazz
norwegian metal	rock
norwegian pop	pop
norwegian rock	rock
novelty music	comedy
novelty ragtime	jazz
nu age	rock
nu disco	r&b and soul
nu electro	hip hop
nu gaze	electronic
nu jazz	jazz
nu metal	rock
nu skool breaks	electronic
nu-cumbia	latin
nu-disco	electronic
nu-funk	electronic
nu-gaze	electronic
nu-nrg	electronic
nueva cancion	latin
nueva canción	latin
nz indie	electronic
oi	african
ok indie	electronic
old school hip hop	hip hop
old-time	jazz
onkyokei	asian
opera	hip hop
operatic pop	pop
orchestral	orchestral
orchestral jazz	jazz
original pilipino music	asian
orquesta tropical	latin
oshare kei	jazz
ostrock	rock
outer hip hop	hip hop
outlaw country	country
outsider	electronic
outsider house	electronic
p funk	r&b and soul
p-funk	r&b and soul
p-pop	asian
pagan black metal	rock
pagan metal	rock
pagode	latin
paisley underground	rock
pakistani pop	pop
palm-wine	african
parody music	comedy
permanent wave	electronic
persian pop	pop
persian traditional	latin
perth indie	electronic
peruvian rock	rock
piano blues	blues
piano rock	rock
piedmont blues	blues
pinoy alternative	country
pinoy pop	asian
pipe band	jazz
poetry	folk
polish hip hop	hip hop
polish indie	electronic
polish jazz	jazz
polish pop	pop
polish punk	rock
political hip hop	hip hop
polynesian pop	pop
pop	pop
pop christmas	pop
pop emo	rock
pop flamenco	latin
pop house	electronic
pop punk	rock
pop rap	pop
pop reggaeton	latin
pop rock	rock
pop soul	pop
pop sunda	asian
popgaze	pop
porro	latin
portland indie	electronic
portuguese rock	rock
post rock	rock
post-bop	jazz
post-disco	r&b and soul
post-doom metal	rock
post-grunge	rock
post-hardcore	rock
post-metal	rock
post-post-hardcore	electronic
post-punk	rock
post-punk revival	rock
post-rock	rock
post-screamo	rock
post-teen pop	pop
power blues-rock	rock
power electronics	electronic
power metal	rock
power noise	electronic
power pop	pop
power violence	rock
power-pop punk	rock
powerviolence	rock
progressive bluegrass	country
progressive country	country
progressive electro house	electronic
progressive folk	folk
progressive house	electronic
progressive metal	rock
progressive pop	pop
progressive post-hardcore	electronic
progressive psytrance	electronic
progressive rock	rock
progressive trance	electronic
progressive trance house	electronic
progressive uplifting trance	electronic
protest song	folk
psybient	electronic
psych gaze	electronic
psychedelic blues-rock	rock
psychedelic doom	rock
psychedelic folk	folk
psychedelic pop	pop
psychedelic rock	rock
psychedelic trance	electronic
psychobilly	rock
psychobilly/punkabilly	country
pub rock	rock
puerto rican rock	rock
punk	rock
punk blues	blues
punk christmas	rock
punk jazz	jazz
punk rock	rock
punk ska	caribbean and caribbean-influenced
punta	caribbean and caribbean-influenced
punta rock	caribbean and caribbean-influenced
r&b	r&b and soul
r&b and soul	r&b and soul
raga rock	rock
ragga	hip hop
ragga jungle	caribbean and caribbean-influenced
raggacore	electronic
ragini	asian
ragtime	jazz
rai	jazz
ranchera	latin
rap	hip hop
rap metal	rock
rap metalcore	rock
rap music	hip hop
rap opera	hip hop
rap rock	rock
rapcore	rock
rara tech	electronic
rasin	caribbean and caribbean-influenced
raï	african
re:techno	electronic
reactionary bluegrass	country
rebetiko	pop
red dirt	country
reggae	caribbean and caribbean-influenced
reggae español/spanish reggae	hip hop
reggae fusion	caribbean and caribbean-influenced
reggae rock	rock
reggaestep	electronic
reggaeton	latin
reggaeton flow	latin
regional mexican	latin
regional mexican pop	pop
retro electro	hip hop
retro metal	rock
rhythm and blues	r&b and soul
rio de la plata	pop
riot grrrl	rock
rock	rock
rock and roll	rock
rock catala	rock
rock en espanol	jazz
rock en español	latin
rock gaucho	rock
rock in opposition	rock
rock noise	avant-garde
rock steady	caribbean and caribbean-influenced
rock-and-roll	rock
rockabilly	country
rocksteady	caribbean and caribbean-influenced
romanian pop	pop
romantic	pop
roots reggae	caribbean and caribbean-influenced
roots rock	rock
rumba	latin
russian hip hop	hip hop
russian pop	pop
russian punk	rock
russian rock	rock
rva indie	electronic
sadcore	rock
sakara	african
salsa	latin
salsa international	latin
salsa romántica	latin
samba	latin
samba rock	latin
samba-enredo	latin
sambass	electronic
sawt	asian
schlager	pop
scottish rock	rock
screamo	rock
screamo punk	rock
screamocore	rock
seattle indie	electronic
sega	african
seggae	african
semba	african
sertanejo	country
sertanejo tradicional	country
sertanejo universitario	country
shangaan electro	african
sheffield indie	electronic
shibuya-kei	jazz
shimmer pop	pop
shimmer psych	pop
shiver pop	pop
shoegaze	rock
show tunes	country
singer-songwriter	latin
singer-songwriter movement	folk
ska	caribbean and caribbean-influenced
ska jazz	jazz
ska punk	rock
ska revival	rock
skate punk	rock
skiffle	folk
skinhead oi	african
skweee	electronic
sky room	electronic
slam death metal	rock
slash punk	rock
slavic metal	rock
slc indie	electronic
sleaze rock	rock
slovak hip hop	hip hop
slovak pop	pop
slovenian rock	rock
slow core	electronic
slow game	electronic
slowcore	rock
sludge metal	rock
smooth jazz	jazz
snap music	hip hop
soca	caribbean and caribbean-influenced
soft rock	rock
son	latin
son cubano	caribbean and caribbean-influenced
song poem	latin
songo	caribbean and caribbean-influenced
songo-salsa	hip hop
sophisti-pop	pop
soukous	african
soul	r&b and soul
soul blues	blues
soul christmas	r&b and soul
soul jazz	jazz
south african jazz	jazz
southern hip hop	hip hop
southern rock	rock
southern soul	r&b and soul
space age pop	pop
space disco	electronic
space music	electronic
space rock	rock
spanish folk	folk
spanish hip hop	hip hop
spanish indie pop	pop
spanish indie rock	rock
spanish new wave	electronic
spanish noise pop	pop
spanish pop	pop
spanish pop rock	rock
spanish punk	rock
spanish reggae	caribbean and caribbean-influenced
spanish rock	rock
speed garage	electronic
speed metal	rock
speedcore	electronic
st. louis blues	blues
st. louis hip hop	hip hop
step	electronic
stomp and flutter	jazz
stomp and holler	jazz
stomp and whittle	jazz
stomp pop	pop
stoner metal	rock
stoner rock	rock
straight edge	jazz
straight-ahead jazz	jazz
street punk	rock
stride	jazz
stride jazz	jazz
string band	jazz
substep	electronic
sufi rock	rock
sung poetry	folk
sunset lounge	easy listening
sunshine pop	pop
suomi rock	rock
suomisaundi	electronic
surf music	caribbean and caribbean-influenced
surf pop	pop
surf rock	rock
swamp blues	blues
swamp pop	pop
swedish alternative rock	rock
swedish eurodance	electronic
swedish folk pop	pop
swedish hard rock	rock
swedish hip hop	hip hop
swedish idol pop	pop
swedish indie pop	pop
swedish indie rock	rock
swedish jazz	jazz
swedish metal	rock
swedish pop	pop
swedish pop punk	rock
swedish prog	electronic
swedish punk	rock
swedish reggae	caribbean and caribbean-influenced
swedish synthpop	pop
swing	jazz
swiss hip hop	hip hop
swiss rock	rock
symphonic black metal	rock
symphonic metal	rock
symphonic rock	rock
synthpop	pop
synthwave	electronic
taarab	african
taiwanese pop	asian
tango	latin
tech house	electronic
tech trance	electronic
techdombe	electronic
technical brutal death metal	rock
technical death metal	rock
techno	electronic
techstep	electronic
tecno brega	electronic
tecnobrega	latin
teen pop	pop
tejano	latin
tekno	electronic
texas blues	blues
texas country	country
thai indie	electronic
thai pop	asian
third stream	jazz
thrash core	electronic
thrash metal	rock
thrash-groove metal	rock
thrashcore	rock
timba	latin
tin pan alley	electronic
tone	caribbean and caribbean-influenced
tracestep	electronic
trad jazz	jazz
traditional blues	blues
traditional british folk	folk
traditional country	country
traditional country music	country
traditional folk	folk
traditional funk	r&b and soul
traditional pop music	pop
traditional reggae	caribbean and caribbean-influenced
traditional rock 'n roll	rock
traditional scottish folk	folk
traditional ska	caribbean and caribbean-influenced
traditional swing	jazz
traditional:	latin
trance	electronic
trance music	electronic
trap	hip hop
trap francais	hip hop
trap music	caribbean and caribbean-influenced
trapstep	electronic
trash rock	rock
triangle indie	electronic
tribal house	electronic
trip hop	electronic
trip hop (or bristol sound)	hip hop
trival	electronic
tropical	latin
tropical house	electronic
tropicalia	latin
tropipop	latin
truck-driving country	country
turbo folk	folk
turkish classical	orchestral
turkish folk	folk
turkish hip hop	hip hop
turkish jazz	jazz
turkish pop	pop
turkish rock	rock
turntablism	hip hop
twee pop	pop
twin cities hip hop	hip hop
twin cities indie	electronic
twoubadou	caribbean and caribbean-influenced
uk dub	electronic
uk funky	electronic
uk garage	electronic
uk hardcore	electronic
uk hip hop	hip hop
uk post-punk	rock
ukrainian rock	rock
unblack metal	rock
underground hip hop	hip hop
underground pop rap	hip hop
underground power pop	pop
underground rap	hip hop
unknown	unknown
uplifting trance	electronic
urban contemporary	pop
urban pasifika	hip hop
v-pop	asian
vallenato	latin
vancouver indie	electronic
vapor house	electronic
vapor pop	pop
vapor soul	r&b and soul
vapor twitch	electronic
vaporwave	electronic
vegan straight edge	jazz
vegas indie	electronic
venezuelan rock	rock
video game music	electronic
vienna indie	electronic
vietnamese pop	pop
viking metal	rock
vintage french electronic	electronic
vintage tango	latin
viral pop	pop
vispop	pop
visual kei	rock
vocal house	electronic
vocal jazz	jazz
vocal trance	electronic
war metal	rock
warm drone	electronic
welsh rock	rock
west african jazz	jazz
west coast blues	blues
west coast hip hop	hip hop
west coast jazz	jazz
west coast rap	hip hop
west coast trap	hip hop
western swing	country
witch house	electronic
wonky	electronic
wonky pop	pop
world	rock
world chill	electronic
world christmas	rock
world fusion	rock
world meditation	rock
world worship	rock
worldbeat	rock
ye ye	r&b and soul
yugoslav rock	rock
zapstep	electronic
zouglou	african
zouglou cote d'ivoire	african
zouk	caribbean and caribbean-influenced
zouk riddim	caribbean and caribbean-influenced
zouk-lambada	latin
zydeco	country
