	['son']
1349	['asian']
2ManyDJs	['rock', 'country', 'electronica', 'electronic', 'jungle', 'punk', 'house', 'pop']
: Roy de Roy	None
ADHD	['son']
Aaron James	None
Abbruch	None
Aborted	['metal', 'grindcore']
Accion Mutante	['comedy']
Achim Kaufmann	None
Adam Holzmann	None
Adi Pflugshaupt	None
Adrian Balmer	None
Adrian Mears	None
Adrian Pflugshaupt	None
Adrien Guerne	None
Alain Altinoglu	['opera']
Alain Veltin	None
Alberto Guareschi	None
Aleksander Gabry	None
Alessandro Rosi	['baroque']
Alessia Grimaldi	None
Alex Cebanica	None
Alex Friedrich	None
Alex Maurer	None
Alexander "Sandi" Kuhn	None
Alexander Brincken	['classical', 'unknown']
Alexander Kuhn	None
Alexandra Huber	None
Alexey Lavrentyev	None
Alice Borciani	None
Aline Burla	None
Alison Burnside Express	None
All Eyes West	None
Alp Bora	None
Alp Bora Quartett	None
Alwin Büchler	None
Amelia Curran	None
Amin Mokdad	None
Amusement Parks on Fire	['rock', 'experimental']
Amélie Mandeville	None
Ana Moura	['fado']
Ana de la Vega	None
Andrea Gygax	None
Andrea Pozza	None
Andrea Suter	None
Andreas Graf	['world']
Andreas Hourdakis	None
Andreas Janke	None
Andreas Lang	['world']
Andreas Sami	None
Andreas Schaerer	None
Andreas Schärer	None
Andreas Stahel	None
Andreas Tschopp	None
Andreas Zingre	None
Andrej Ichtchenko	None
Andres Velez	None
Andrey Murphy	None
András Schiff	['house', 'classical']
André Desponds	None
André Pousaz	None
Andy Kurz	None
Angela Beffa	None
Angelika Express	['punk', 'rock', 'pop']
Angelika Kirchschlager	['opera', 'house']
Angelo Christidis & Jens Krieg	None
Angry Buddha	None
Ania Losinger	None
Anna Netrebko	['opera']
Anna Vasilyeva	None
Annalise Bereiter	None
Anne Sofie von Otter	['baroque', 'opera', 'house']
Anne-May Krüger	None
Annetta Debrunner	None
Antje Thierbach	None
Antonia	None
Antonios Stoitsoglou	None
Apologies I Have None	None
Arlette Meier	None
Armando Bucher	None
Arne Huber	None
Arno Haas	None
Arno Schulz	None
Ashley Prewett	None
Asking Alexandria	['metal', 'dubstep', 'rock', 'hardcore', 'electronicore', 'metalcore', 'punk', 'classic', 'pop']
Asphyx	['metal', 'celtic']
Aude Priya	None
Aurel Hassler	None
Aurel Nowak	None
Aurora Nealand	None
Axel Andrae	None
Axel Pape	None
Baba The Fayahstudend	None
Barbara Ciannamea	None
Barbara Erni	None
Barbara Wildberger	None
Bare Noize	None
Bartek Niziol	['opera']
Basil Anliker	None
Beat Anderwert	None
Beat Baumli	None
Beat Müller	None
Beatrice Rogger	None
Benedetto Lupo	None
Benedikt Reising	None
Benedikt Wieland	None
Beni Külling	None
Beni Leumann	None
Benjamin Engeli	None
Benjamin Noti	None
Benjamin Nyffenegger	None
Benjamin Reinhart	None
Benjamin Schmid	None
Benno Ernst	None
Bernhard Bamert	None
Betontod	['punk', 'rock']
Bettina Weder	None
Big Freedia	['rap', 'electro', 'african', 'disco', 'funk', 'bounce', 'world', 'edm']
Big Freedia & The Divas	None
Bill Payne	['rock', 'trap', 'step', 'blues', 'funk', 'mambo', 'world', 'unknown']
Billy Martin	['world', 'unknown']
Billy Martin's Wicked Knee	None
Björn Again	['europop', 'pop', 'disco']
Black Light Burns feat. Wes Borland	None
Bobby Wissmann	None
Bonded By Blood	['metal']
Boogie Connection	['boogie']
Boomrush Backup	None
Boris Previic	None
Born Gold	['electronic', 'experimental', 'indietronica', 'futurepop']
Bouganville	None
Boys Noize	['electronica', 'electro', 'disco', 'techno', 'minimal', 'punk', 'house', 'pop']
Brendan Wade	None
Brian Franklin	None
Bruce Roberts	None
Bruno Duvall	None
Bruno Haag	None
Bruno Huwyler	None
Bruno Spoerri	['electronica']
Bryan Grob	None
Bänz Oester	None
C.Daletska	None
C.Glaser	None
Caesar Perrig	None
Cancer Bats	['punk', 'rock', 'metal', 'metalcore', 'hardcore']
Canja Rave	None
Cara	None
Caravan Palace	['swing', 'electro', 'house']
Carla Blackwood	None
Carlo Menger	None
Carlo Moreni	None
Carlo Niederhauser	None
Carmen Bürgisser	None
Carola Glaser	None
Carola Wirth	None
Caroline Fahrni	None
Catriona Bühler	None
Chang-Drouin	None
Charlie Schumacher	None
Charlotte Dentan	None
Charly Antolini	['world']
Che Sudaka	['rock', 'rumba', 'punk', 'ska']
Chen Yan	None
Chica Torpedo	None
Chin-Ting Huang	None
Chip Crawfort	None
Chris Liebing	['techno']
Christa Kohli	None
Christian Buck	None
Christian Buehrle	None
Christian Dierstein	None
Christian Fotsch	None
Christian Gutfleisch	None
Christian Hieronymi	None
Christian Meyers	None
Christian Müller	None
Christian Niederer	None
Christian Rösli	None
Christian Schütz	None
Christian Spahni	None
Christian Sutter	None
Christian Wallner	None
Christian Weber	None
Christian Winiker	None
Christian Wolfarth	None
Christina Daletska	None
Christina Fassbender	None
Christina Jaccard	None
Christina Wyss	None
Christine Esser	None
Christine Hu	None
Christine Meier	['world']
Christof Jaussi	None
Christoph Baumann	None
Christoph Dangel	None
Christoph Grab	None
Christoph Irniger	None
Christoph Neuhaus	None
Christoph Pfaff	None
Christoph Prégardien	['baroque']
Christoph Steiner	None
Christoph Stiefel	None
Christophe Huguenin	None
Christopher Jepson	None
Christy Doran	None
Claire Huangci	['classical']
Claire Huguenin	None
Claire Pigagnol	None
Clannad	['rock', 'electronica', 'celtic', 'folk', 'world', 'pop']
Claude Bucher	None
Claude Diallo	None
Claude Hauri	None
Claudia Greber	None
Claudia Vollenweider	None
Claudio Burri	None
Claudio Moser	None
Claudio Strebel	None
Claudio Strüby	None
Clemens Hagen	None
Colin Vallon	None
Conductor: Marcus Weiss	None
Conor Oberst	['rock', 'folk', 'country']
Conrad Zwicky	None
Container 6	None
Cookie The Herbalist	None
Corinne A. Sutter	None
Corinne Chapelle	None
Cornelia Arn	None
Cornelius Buser	None
Corrosive	None
Covenant	['world']
Crazy Lixx	['rock', 'metal', 'hardcore']
Cristina Janet	None
Curtis Fowlkes	['lounge']
Cäsar Zurbriggen	None
Céline Akça	None
Céline-Giulia Voser	None
DJ Count Crophead	None
DJs Daddy K	None
DJs Karpalo	None
DJs Mango Alemania	None
DJs Mauri	None
Dada Life	['punk', 'electro', 'edm', 'house']
Dalia Donadio	None
Dan Agent	None
Dani Eberhard	None
Dani Solimine	None
Daniel Buess	['experimental', 'classical', 'noise']
Daniel Fueter	None
Daniel Haefliger	None
Daniel Hope	None
Daniel Kahn & The Painted Bird meet the Brothers Nazaroff	None
Daniel Moos	None
Daniel Röhn	None
Daniel Studer	None
Daniel Weber	None
Daniel Zisman	None
Daniil Trifonov	['classical']
Danilo Boggini	None
Danilo Moccia	None
Danja Schwegler	None
Danny Reichlin	None
Daria Zappa	None
Dark Cloud	['electronic', 'metal', 'world', 'son']
Dave Blaser	None
Dave Doran	None
Dave Eichenberger	None
Dave Feusi	None
Dave Gisler	None
Dave Ruosch	None
David Beglinger	None
David Bokel	None
David Frühwirth	None
David Helbock	None
David Reitz	None
David Schwarz	None
David Zopfi	None
Davie Gisler	None
Debauchery	['metal', 'rock']
Dejan Terzic	None
Delinquent Habits	['rap', 'hardcore']
Delirio	None
Denis Beuret	None
Denison Witmer	['rock', 'lounge', 'folk', 'americana', 'house']
Derek Clark	['house']
Deu Choro	['choro']
Diana Petrova	None
Die Blockflöte des Todes	None
Dieter Häner	None
Dieter Ulrich	None
Diskomurder	None
Django Bates	['house', 'classical']
Domenic Landolf	None
Domenico Tagliente	None
Dominic Egli	None
Dominik Blum	None
Dominik Eberle	None
Dominik Rüegg	None
Dominik Wörner	['baroque', 'opera']
Dominique Dieth	None
Donat Fisch	None
Donny McCaslin	['house']
Donny McCaslin Group	None
Donzela guerreira	None
Doran-Kaenzig-Hemingway	None
Doran-Känzig-Hemingway	None
Dorit Chrysler	['electronic', 'electro']
Dota	['electronic', 'world', 'asian']
Doug Hammond	['funk']
Drizella	None
Dropkick Murphys	['rock', 'hardcore', 'chanson', 'celtic', 'folk', 'blues', 'punk', 'classic', 'house', 'son']
Duan Aiai	None
E. Rütsche	None
E. Streiff	None
Eastern Standard Time	None
Eckart Heiligers	None
Eckhard Stromer	None
Edgar Marc Petter	None
Edmauro de Oira	None
Edmund Worsfold Vida	None
Eduardo Egüez	['tango', 'latin']
Efterklang	['rock']
Egidius Streiff	None
Einat & Hakim	None
Einat Betzalel	None
Electric Hellessence	None
Elena Tomilova	None
Eleni Mandell & Sylvie Lewis	None
Eliane Cueni	None
Elina Duni	['synthpop']
Elisabeth Berner	None
Elisabeth Flechl	None
Elisabeth Meyer	None
Elliott Levin	None
Elysa Kay	None
Emanuel Ax	['jungle', 'classical']
Emanuel Rütsche	None
Emanuel Schnyder	None
Emanuele Forni	None
Emiliano Arboleda	None
Emily Wells	['rock']
Emmanuel Harold	None
Emmanuel Pahud	['world', 'baroque', 'experimental', 'orchestral', 'classical']
End of Silence	['rock', 'metal']
Ensemble Sortisatio	['classical']
Enter Shikari	['metal', 'rock', 'dubstep', 'hardcore', 'electronicore', 'industrial', 'electro', 'screamo', 'noise', 'punk', 'house', 'son']
Erich Tiefenthaler	None
Erika Achermann	None
Erikson Cabrera	None
Ernst Grädel	None
Ernst Waespe	None
Erwin Pfeifer	None
Erwin Schrott	['opera', 'house']
Estelle Costanzo	None
Esther Pitschen	None
Eszter Major	None
Eths	['metal', 'deathcore', 'metalcore']
Etienne Abelin	None
Etienne Marti	None
Eva Boesch	None
Eva Kesselring	None
Evgeni Koroliov	['classical']
Evgeniya Kossmann	None
Ewa Kupiec	['classical']
Fabian Anderhub	None
Fabian Baur	None
Fabian Bürgi	None
Fabian Eberle	None
Fabian Gutscher	None
Fabian Keist	None
Fabian M. Mueller	None
Fabienne Ambühl	None
Fabienne Hoerni	None
Fabio Pinto	['world']
Felix Brühwiler	None
Felix Gubser	None
Felix Haller	None
Felix-Andreas Genner	None
Ferdinand Povel	None
Fere Scheidegger	None
Feres Hot Strings	None
Fetish Solo	None
Fides Auf der Maur	None
Filippo Morace	None
Flamencos de Morón	None
Flavio Rohner	None
Flavio Spirgi	None
Fler	['rap']
Florian Arbenz	None
Florian Egli	None
Florian Favre	None
Florian Favre Trio	None
Florian Grupp	None
Florian Keller	None
Florian Möbes	None
Florian Truebsbach	None
Florian Widmer	None
Floriano Inacio Junior	None
Foreign Beggars	['dubstep', 'grime', 'rai', 'brostep']
Francis Petter	None
Franco Casagrande	None
Frank Sanderell	None
Frank Turner And The Sleeping Souls	None
Franz Hellmüller	None
Franziska Hatz	None
Françoise Rivalland	None
Fred Bürki	None
Fred Tackett	['rock', 'americana', 'blues', 'mambo']
Freddy Benitez	None
Frederik Köster	None
Frequency Jones	None
Fridolin Blumer	None
Friedemann A. Treiber	None
Friedemann Treiber	None
Fritz Hauser	['classical']
Frédéric Petitprez	None
Fulvia Mancini	None
Furio Zanasi	None
Félix Rossy	None
G. Calvin Weston	None
Gabe Ford	['rock']
Gabriel Adorjan	None
Gabriel Meyer	None
Gabriela Friedli	None
Gabriela Tanner	None
Gabriella Colecchia	None
Ganesh Geymeier	None
Gavlyn	None
Gaël Zwahlen	None
Gaëtan Lagrange	None
Geneviève Strosser	None
Georg Hofmann	None
Gerry Hemingway	None
Gert Schimak	None
Get Well Soon	None
Giancarlo Prossimo	None
Gianluca Giger	None
Gianmaria Testa	['rock', 'chanson']
Giantree	None
Gina Günthard	None
Gitte Deubelbeiss	None
Giulia del Re	None
Gregor Loepfe	None
Gregory Porter	['soul', 'gospel', 'blues', 'funk', 'classic', 'house']
Greis	None
Grégoire Vuilleumier alias Greis	None
Gudrun Petruschka	None
Gwilym Simcock	['classical']
Haika Lübcke	None
Hakim Boukhit	None
Hannes Bärtschi	None
Hannes Bürgi	None
Hans Adolfsen	None
Hans Christoph Begemann	None
Hans Feigenwinter	None
Hans Hassler	['baroque', 'classical']
Hans Joerg Fink	None
Hans Krauer	None
Hans-Jürgen Studer	None
Hanspeter Krüsi	None
Hansruedi Gattiker	None
Hansueli Oesch	None
Harald Haerter	None
Hardy Appich	None
Harry Lenherr	None
Haut & Courte	None
Hayden Chisholm	['experimental', 'classical']
Heather Roche	None
Heidi-Maria Makkonen	None
Heiner Grieder	None
Heinz Gasser	None
Heinz Geisser	None
Heinz Holliger	['opera', 'classical']
Heinz Sauer	None
Heiri Kaenzig	None
Heiri Känzig	None
Helen Iten	None
Helena Winkelman	None
Helga Varadi	None
Hells Belles	None
Helmut Deutsch	['world', 'opera', 'classical']
Herb Bucher	None
Herbert Kramis	None
Herbert Pirker	None
Herbie Kopf	None
Herman Peter	None
Herman Van Veen	['cabaret']
Herman van Veen	['cabaret']
Hermann Bühler	None
Hermann Oswald	['opera']
Hidden Orchestra	['world', 'reggae', 'idm', 'dub', 'electronica']
Hieronymus Schädler	None
Hille Perl	['baroque']
Hiram Mutschler	None
His Clancyness	['rock', 'krautrock', 'pop', 'noise']
Honig	None
Hp Brack	None
Hurricane Dean	['tropical', 'world', 'minimal', 'latin']
Huss & Hodn	None
Hämi Hämmerli	None
Hütte	None
I Got You On Tape	['rock']
Ignacio de Amparo	None
Igor Morosow	None
Iiro Rantala	['world', 'classical', 'tango']
In Strict Confidence	['electro']
Ingrid Lukas	None
Isa Wiss	None
Isabel Heusser	None
Iva Denes	None
Ivan Hrdina	None
Ivan Kubias	None
Ivan Monighetti	None
Ivo Pogorelich	['folk', 'classical', 'romantic']
JJ & Palin	None
JJ Flück	None
Jakob Hug	None
Jakob Pilgram	None
James Bailey	['classical']
James Blood Ulmer	['rock', 'blues', 'house', 'world']
James Gilchrist	None
Jan Eschke	None
Jan Geiger	None
Jan Schlegel	None
Jan Schreiner	None
Janek Rosset	None
Janine Cathrein	None
Jasmin Scheidegger	None
Javier Heredia	None
Jayce Lewis	['rock', 'asian', 'son', 'world', 'pop', 'unknown']
Jean Pierre Magnet y Serenata de los Andes	None
Jean-Daniel Girod	None
Jean-François Lessard	None
Jean-Sélim Abdelmoula	None
Jeannine Hirzel	None
Jeff Hirshfield	None
Jeff Zima	None
Jennifer Kay Aynilian	None
Jens Loh	None
Jens Peter Maintz	None
Jens-Peter Maintz	None
Jeremias Keller	None
Jersey Julie	None
Jersie Julie & Band	None
Jessica Rona	None
Jim Boyd	None
Joachim Enders	None
Joe Schwach	None
Joel Marosi	None
Joel Reiff	None
Johann Novell	None
Johannes Schleiermacher	None
Johannes Zahlten	None
John Marshall	['metal']
John Voirol	None
Jonas Iten	None
Jonas Labhart	None
Jonas Ruther	None
Jonas Winterhalter	None
Jonas Zürcher	None
Jonathan Peek	None
Jooce Garret	None
Joseph Bowie	['punk', 'bounce', 'rock', 'funk', 'blues']
Josquin Rosset	None
José Carreras	['opera']
Joy Denalane	['folk', 'reggae', 'soul', 'pop', 'african']
Juan Pablo Herrera	None
Judith Goldbach	None
Juilliard String Quartet	['classical']
Julia Keller	None
Julia Pichler	None
Julian Joseph	None
Julian Pieber	None
Julian Sartorius	None
Justin Peake	None
Justin Vali Trio	None
Jérémie Bochet	None
Jürg Bucher	None
Jürg Dähler	None
Jürg Lietha	None
Jürg Luchsinger	None
Jürg Metzger	None
Jürg Ramspeck	None
Jürg Wickihalder	None
Jürg Zurmühle	None
Jürgen Bothner	None
Jürgen Waidele & Friends feat. Elysa Kay	None
KJ Christy Doran	None
Kaisa	None
Kalli Gerhards	None
Kammerorchester der Philharmonie Novosibirsk	None
Kara Sylla Ka	None
Karel Boeschoten	None
Karin Dornbusch	None
Karin Meier	None
Karl Raas	None
Karma to Burn	['rock', 'metal']
Kaspar von Grünigen	None
Kendrick Lamar	['rock', 'hardcore', 'freestyle', 'electronica', 'rap', 'house', 'funk', 'world', 'soul']
Kenneth Henderson	['rock', 'house']
Kenny Gradney	['rock', 'folk', 'blues', 'funk', 'mambo']
Kersantti Kankkunen	None
Kevin Buri	None
Kevin Chesham	None
Khatia Buniatishvili	['country', 'classical']
Khin Hong Yip	None
Kim Roloff	None
Kirill Zwegintsow	None
Klara Lundén	None
Klaus-Peter Riemer	None
Kofelgschroa	None
Koller	None
Kristina Koropecki	None
Kristóf Zámbó	None
Krystian Zimerman	['opera', 'classical', 'romantic']
L. Pfister	None
Lars Lindvall	None
Laszlo Polus	None
Laura Schuler	['world', 'blues']
Laura Wiesmann	None
Leila Josefowicz	['classical', 'romantic', 'unknown']
Lena Stöhrfaktor	None
Leon Duncan	None
Leonardo Bortolotto	None
Lev Pupis	None
Liane Ehlich	None
Lilabungalow	None
Lilia Tripodi	None
Lilly Thornten Quintett	None
Lilly Thornton	None
Linah Rocio	None
Linda Campanella	None
Lino Blöchlinger	None
Linus Hunkeler	None
Lionel Friedli	None
Lionel Gafner	None
Liquid Land	None
Lisa Hasler	None
Lisa Hoppe	None
Lisa de la Salle	None
Lisette Spinnler	None
Little Feat	['rock', 'blues', 'mambo', 'country']
Ljupka Hadzigeorgieva	None
Loco Slickers	None
Lorenzo Petrocca	None
Louis Schwizgebel	['classical']
Love & Girls	['world', 'electropop']
Luca Leombruni	None
Luca Sisera	None
Lucas Niggli	None
Lucas Rössner	None
Luis Esnaola	None
Lukas Briggen	None
Lukas Gasser	None
Lukas Graham	['funk', 'soul']
Lukas Hagen	None
Lukas Heuss	None
Lukas König	None
Lukas Roos	None
Lukas Wyss	None
Luo Xiaoci	None
Luzia von Wyl	None
M.Krejcik	None
Maciré Sylla	['world', 'funk']
Madlen Donadio	None
Maersung	None
Maestro David Cowan	None
Maja Barroso Lisac	None
Malcolm Braff	None
Mani Zweili	None
Manu Hagmann	None
Manuel Buser	None
Manuel Walser	None
Marc Ducret Tower Zero	None
Marc Edwards	None
Marc Stucki	None
Marc Unternährer	None
Marcel Papaux	None
Marcel Ricklin	None
Marcel Rüegg	None
Marcello Mosca	None
Marco Käppeli	None
Marco Leali	None
Marco Müller	None
Marco Schubiger	None
Marco von Orelli	None
Marcus Rojas	['metal', 'world']
Marcus Weiss	['orchestral']
Mareike Wiening	None
Maren Kessler	None
Margaret Leng Tan	['classical']
Margit Beukman	None
Margrit Rieben	None
Maria Doyle Kennedy	['folk']
Maria Doyle Kennedy & Kieran Kennedy	None
Maria Goldschmidt	None
Maria Shabashova	None
Marian Krejcik	None
Marianne Racine	None
Marie-Odile Vigreux	None
Marilia Vargas	None
Marino Pliakas	None
Mario Giovannelli	None
Marius Peyer	None
Mark Berube	None
Mark Berube & The Patriotic Few	None
Mark Eitzel	['rock', 'trap', 'punk', 'son']
Mark Peterson	None
Mark Tenger	None
Markus Eichenberger	None
Markus Forrer	None
Markus Hochuli	None
Markus Hürsch	None
Markus Kienzl	None
Markus Nikänen	None
Markus Nykänen	None
Markus Schmied	None
Markus Schramhauser	None
Markus Wursch	None
Marsimoto Soundsystem	None
Martijn Vanbuel	None
Martin Bliggenstorfer	None
Martin Carl	None
Martin Dahanukar	None
Martin Gaisser	None
Martin Heini	None
Martin Jaggi	None
Martin Meyer	None
Martina Gmeinder	None
Martina Schucan	None
María Cecilia Muñoz	None
Mat Callahan	['rock', 'folk', 'world', 'worldbeat']
Mathew Barley	None
Mathias Bucher	None
Mathias Demmer	None
Mathias Hausmann	None
Mathias Weibel	None
Mats Eser	None
Matt MItchell	None
Matthew Lonson	None
Matthew Savnik	None
Matthias Arter	None
Matthias Grupp	None
Matthias Kohler	None
Matthias Lincke	None
Matthias Rácz	None
Matthias Sannemüller	None
Matthias Spillmann	None
Matthias Tschopp	None
Matthias Wenger	None
Matthieu Michel	None
Maurice Steger	['baroque', 'classical']
Mauro Bodio	None
Mauro Pesenti	None
Maurus Conte	None
Max Andrzejewski	None
Max Haft	None
Maxime Delporte	None
Mazrice Heugen	None
Meret Roth	None
Micha Krähenbühl	None
Michael Anklin	None
Michael Arbenz	None
Michael Beck	None
Michael Büschelmann	None
Michael Chylewski	None
Michael Feyfar	None
Michael Leherbauer	None
Michael Wollny	None
Michael Zisman	None
Michel Gsell	None
Michel Rouilly	None
Michel Wintsch	['punk', 'latin', 'ska', 'rap', 'soul', 'stride', 'swing', 'poetry', 'folk', 'blues', 'bebop', 'dixieland', 'orchestral']
Michele Maddaloni	None
Michele Siciliano	None
Michi Stulz	None
Michiko Tsuda	None
Mickie Krause	['schlager']
Micro Jackson	None
Miguel Müller	None
Mike Bischof	None
Mike Malloth	None
Mike Maloth	None
Mike Maurer	None
Miklos Perenyi	['banda', 'classical']
Minas Morgul	None
Mindflaire	None
Miriam Klein	None
Mirjana Reinhard	None
Miro Rutscho	None
Miro Steiner	None
Mischa Greull	None
Mischa Stirnimann	None
Missstand	None
Modestep	['rock', 'dubstep']
Monika Baer	None
Monika Hächler	None
Monika Mauch	None
Moose Jackson	None
Moreno Donadio	None
Moritz Müllenbach	None
Motorama	['rock', 'coldwave']
Muneer B. Fennell	None
Muriel Zemp	None
Mutiny on the Bounty	['romantic']
Mélodie Zhao	['classical', 'unknown']
Nada Anderwert	None
Naoki Kitaya	None
Napalm Death	['metal', 'hardcore', 'techno', 'grindcore', 'dub', 'punk', 'world', 'soul']
Natalie Chee	None
Nate Wood	None
Nathalie Maerten	None
Navel	['jungle', 'latin']
Nelson Goerner	None
Nic Niedermann	None
Nicholas Angelich	['classical']
Nick Gutersohn	None
Nick Nobody	None
Nicola Katz	None
Nicole Johänntgen	None
Nik Bärtsch	['funk']
Niko Seibold	None
Nina Baredi	None
Nina Rechsteiner	None
Nino Lentini	None
Nino Wenger	None
Norbert Ackermann	None
Norbert Pfammater	None
Noémie Cotton	None
Noëmi Nadelmann	['baroque', 'opera', 'house']
Olivia Schenkel	None
Olivier Darbellay	None
Olivier Mas	None
Omar Gudjonsson	None
Omar Kramis	None
Omri Ziegele	None
On-Off	['rock']
Or Illi	None
Or Schnyder	None
Or Töngi	None
Oscar García	None
Oskar Gudjonsson	None
Oswal Canales	None
Othella Dallas	None
Oy Division	None
Paco de Amparo	None
Paolo Vignaroli	None
Pascal Viglino	None
Pat Hargreaves	None
Patrice Moret	None
Patricia Draeger	None
Patricia Kunz	None
Patrik Fitzgerald	['punk', 'folk', 'rock', 'house', 'unknown']
Patrik Zosso	None
Paul Barrere	['rock', 'cajun', 'blues', 'funk', 'mambo']
Paul Clarvis	['tone', 'son']
Paul Kleber	None
Paul Märki	None
Paulo Ferreira-Lopes	None
Pete Borel	None
Peter Conradin Zumthor	None
Peter Horisberger	None
Peter Hunziker	None
Peter Keller	None
Peter Livers	None
Peter Preibisch	None
Peter Scheidegger	None
Peter Schmidlin	None
Peter Schneider	None
Peter Tico Keller	None
Peter Trachsel	None
Petra Vogel	None
Petrit Ceku	['classical']
Philippe Emanuel Haas	None
Pierre Bernhard	None
Pierre Favre	['house', 'latin']
Pieter Wispelwey	['baroque', 'opera', 'classical', 'house']
Pikku E	None
Pink Pedrazzi	None
Pino Buoro	None
Pistolero Pepe	None
Pit Furrer	None
Pius Baschnagel	None
Priska Zaugg	None
Pyro	['world', 'house']
Pädu Ziswiler	None
Queen Esther	None
R. Rütti	None
R.Romei	None
Rafael Schilt	None
Raffaele Bossard	None
Ragnarok	['metal', 'world', 'soul']
Rahel Kohler	None
Raimund Seidl	None
Rainer Apel	None
Rainer Hagmann	None
Rainer Schmidt	['world']
Raphael Christen	None
Raphael Felber	None
Raphael Jakob	None
Raphael Preuschl	None
Raphael Wallfisch	['classical']
Raphael Walser	None
Rea Claudia Kost	None
Rea Dubach	None
Rea Garvey	['rock', 'pop']
Rea Hunziker	None
Rebecca Spiteri	None
Redska	None
Redwan Fayahwan	None
Reggie Washington	None
Regula Gutierrez	None
Reinhold Friedrich	None
Reiny Schnyder	None
Renate Steinmann	None
Renaud Garcia-Fons	['flamenco']
René Grimm	None
René Marzolf	None
René Mosele	None
Res Hafner	None
Reto Burrell	None
Reto Giacopuzzi	None
Reto Langenegger	None
Reto Staub	None
Reto Suhner	None
RhythmTalk	None
Ricardo Mirabelli	None
Riccardo Minasi	['baroque']
Rich Fonje	None
Richard Pechota	None
Richard Pizzorno	None
Richard Walters	None
Richie Winkler	None
Rico Baumann	None
Rita Ékes	None
Ritzy Bryan	None
Rob Cambre	None
Rob Solomon	None
Robert Buri	None
Robert Crowe	None
Robert Koller	None
Robert Morgenthaler	None
Roberth Horvath	None
Roberto Plano	None
Robin Peter Müller	None
Roger Girod	None
Roger Nickl	None
Roger Zeller	None
Roland Heinz	None
Roland Meder	None
Roland Raphael	None
Rolando Garza	None
Rolf Breyer	None
Rolf Caflisch	None
Rolf Lyssy	None
Rolf Romei	None
Roli Kneubühler	None
Rolph Dreier	None
Roman Schmid	None
Ron Carter	['son']
Ron Marsman	None
Ron Pope	['rock', 'pop']
Ronnie Graupe	None
Ronny Graupe	None
Rossana Rossignoli	None
Rubio de Pruna	None
Ruedi Vögeli	None
Ruth Wäger	None
Ryszard Groblewski	None
Rémi Panossian	None
Sabine Poyé Morel	None
Sally Fortino	None
Sam Chapman	['world']
Sam Clayton	['rock', 'country', 'gospel', 'folk', 'blues', 'mambo']
Sam Siegenthaler	None
Sam Walton	['rock']
Samuel Dühsler	None
Samuel Fried	None
Samuel Joss	None
Samuel Jäggi	None
Samuel Mösching	None
Samuel Zünd	None
Samuele Sciancalepore	None
Sandra Merk	None
Sandra Rayne	None
Sandra Weiss	None
Sandro di Pisa	None
Sara Jovanovic	['rock', 'classical', 'pop']
Sarah Büchi	None
Sarah Wegener	None
Sarah Weilenmann	None
Sareena Overwater	None
Schmand	None
Scream Your Name	None
Scumbucket	None
Sebastian Ott	None
Sebastian Pietrowiak	None
Sebastian Studnitzky	None
Sergej Simbirev	None
Sergey Mushtakoff	None
Sergio Azzolini	['classical']
Severin Graf	None
Sezen Aksu	['pop']
Sha	['world']
Shady & The Vamp	None
Sidsel Endresen	['rock']
Silvan Hürlimann	None
Silvan Jeger	None
Silvan Loher	None
Silvan Schmid	None
Silvia Harnisch	None
Silvio Cadotsch	None
Simon Berz	None
Simon Borer	None
Simon Cathrein	None
Simon Crawford-Phillips	None
Simon Fuchs	None
Simon Heggendorn	None
Simon Iten	None
Simon Petermann	None
Simon Schellnegger	None
Simon Wirsch	None
Simone Hager	None
Simone Keller	['classical']
Simone Lustenberger	None
Simonetta Tancredi	None
Sin-City	None
Siro Müller	None
Skinny Lister	['punk', 'folk', 'rock', 'pop', 'noise']
Smalltown Casanovas	None
Sofa Surfers	['rock', 'dub']
Sofus Gleditsch	None
Solme Hong	None
Soner Tezcan	None
Sonoko Ogowa	None
Soo-Hyun Park	None
Sophie Chaillot	None
Sophie Lüssi	None
Spleen United	['rock', 'synthpop']
Stefan Aeby	None
Stefan Aegerter	None
Stefan Eberhard	None
Stefan Jaun	None
Stefan Keller	['classical']
Stefan Schramm	None
Stefan Zwicky	None
Stefanie Kunckler	None
Stefano Risso	None
Stephan Keller	None
Stephan Kurmann	None
Stephan Reinthaler	None
Stephan Wyss	None
Stephane Blanc	None
Stephane Payen	None
Steven Bernstein	None
Stranger Cole	['reggae', 'rocksteady', 'ska']
Strauss	['unknown', 'world', 'son']
Studnitzky	None
Sumina Studer	None
Sunghoon Simon Hwang	None
Susanna Hefti	None
Susanna Moncayo	None
Susanne Bretscher	None
Susanne Doll	None
Susanne Kern	None
Susanne Petersen	None
Svend Capol	None
Syberen van Munster	None
Système D	['rock', 'pop', 'baila']
Talco	['punk', 'banda', 'ska']
Tamar Halperin	['baroque']
Tang Xiaofeng	None
Tanja von Arx	None
Tatjana Nikic	None
Tellavision	None
Teodoro Anzellotti	None
Teresa Ríos	None
Terrible Feelings	None
Tevfik Kuyas	None
The Black Atlantic	['african']
The Black Magic Six	None
The Blackberry Brandies	None
The Busters	['reggae', 'pop', 'ska']
The Culture in Memoriam	None
The Great Hans Unstern Swindle	None
The Jancee Pornick Casino	None
The Joy Formidable	['rock', 'grunge', 'pop', 'noise']
The Luck	None
The Pearlbreakers	None
The Sawyer Family	['classic', 'house']
The Script	['rock', 'world', 'rap', 'pop']
The Setadytones	None
The Vibrators	['rock', 'punk', 'pop']
Theodoros Kapilidis	None
Thomas Bauser	None
Thomas Blumenthal	None
Thomas Bosshard	None
Thomas Castaneda	None
Thomas Dürst	None
Thomas García	None
Thomas Grüninger	None
Thomas Hampson	['poetry', 'world', 'opera', 'classical', 'house']
Thomas Hirt	None
Thomas Kull	None
Thomas Lähns	None
Thomas Lüthi	['world']
Thomas Moeckel	None
Thomas Scheytt	None
Thomas Winkler	['metal', 'neoclassical', 'rock']
Till Grünewald	None
Tillmann Reinbeck	None
Tilmann Zahn	None
Tim Lefebvre	['rock', 'funk', 'electronica', 'electronic']
Tobias Frankenreiter	None
Tobias Hoffmann	None
Tobias Hunziker	None
Tobias Meier	None
Tobias Schmid	None
Tom Bodenmann	None
Tom Linder	None
Tom Mäder	None
Tomi Kuusisto	None
Tomi Schwarzenbach	None
Tommy Baldu	None
Tomoko Iwasa	None
Toni Donadio	None
Tonico da Silva	None
Tonio Morin-Vargas	None
Tony Renold	None
Torsten Laux	None
Touchy Mob	None
Trey Songz	['rap']
Tweak Bird	None
U Brown	['reggae']
Ueli Heiniger	None
Ull Möck	None
Ulrich S. Eggimann	None
Uristier	None
Urs Bolle Rellstab	None
Urs Bollhalder	None
Urs C. Eigenmann	None
Urs Leimgruber	['classical']
Urs Rellstab	None
Urs Wäckerli	None
Ursula Füri-Bernhard	None
Ursula Sarnthein	None
Ursula Toscheff	None
Uwe Schönbeck	None
Vader	['metal']
Valentin Dietrich	None
Vera Cathrein	None
Vera Fischer	None
Vera Kappeler	None
Verena Barbara Gohl	None
Verena Pavoni	None
Veronika Hagen	['classical']
Viktoria Mullova	['classical']
Vinz Vonlanthen	None
Vital Julian Frey	['son']
Vital-Julian Frey	None
Vito Cadonau	None
Vitti Müller	None
Vivid Curls	None
Vlad Weverbergh	None
Volker Engelberth	None
Wallis Bird	['folk', 'rockabilly']
Walter Kaiser	None
Walter Klingner	None
Wankelmut	['jungle', 'house', 'electronica']
We Set the Sun	None
Wege Wüthrich	None
Wei-Zhong Lu	None
Wen Hui Tsai	None
Wen Lu-Hu	None
Wiktor Kociuban	None
Willi Zimmermann	None
Willy Surbeck	None
Wini Holzenkamp	None
Wishbone Ash	['rock', 'blues']
Wolfgang Zumpe	None
Wolfram Rieger	None
Xavier Alig	None
Yann Rouiller	None
Yannick Schmutz	None
Yeol Eum Son	['asian', 'classical', 'son']
Yesterday Shop	None
Yevgeny Sudbin	['classical']
Yi-Chen Lin	None
Yosuke Sate	None
Yosvany Quintero	None
Youssouf Diabate	None
Yukiko Ishibashi	None
Yuta Takase	None
Yves Marguet	None
Yves Reichmuth	None
Yvonne Moore	None
Yvonne Ritter	None
Zhou Tao	None
works by Herbert Willi	None
Àgnes Vass	None
